// THis is the hard 42 x 40 maze
int mat[][] = {{0,3,3,3,3,0,0,3,3,3,3,0,0,0,3,3,3,3,3,3,3,2,3,3,3,3,3,3,0,3,0,3,3,0,0,3,3,0,0,0,0,3},
                {0,3,0,0,3,3,3,3,0,0,0,0,3,3,3,0,0,0,0,0,3,3,0,0,0,0,0,3,0,3,0,3,0,0,0,0,3,3,3,3,0,3},
                {0,3,3,0,0,0,0,0,0,3,3,3,3,0,0,0,3,3,3,0,0,0,0,3,0,3,0,3,0,3,0,3,0,3,3,3,3,0,0,3,3,3},
                {0,3,0,0,0,3,0,3,3,3,0,0,0,0,3,0,3,0,3,3,3,3,3,3,3,3,0,3,3,3,0,3,3,3,0,0,3,3,0,0,3,0},
                {3,3,3,0,3,3,0,3,0,0,0,0,0,0,3,0,3,0,0,0,0,0,0,0,0,0,0,0,0,0,0,0,0,3,0,0,0,0,0,0,3,0},
                {3,0,3,0,3,0,0,3,3,0,3,3,3,3,3,0,3,3,3,3,3,3,0,0,3,0,0,3,3,3,3,3,0,3,3,3,3,3,3,0,3,0},
                {3,0,3,0,3,3,0,0,3,0,3,0,0,0,3,0,0,0,0,0,0,3,0,3,3,3,3,3,0,3,0,3,3,3,0,3,0,0,3,0,3,0},
                {3,0,0,0,0,3,3,3,3,3,3,0,3,0,3,3,3,3,3,0,3,3,3,3,0,0,0,3,0,0,0,3,0,0,0,0,0,0,0,0,0,0},
                {3,3,3,3,0,0,0,0,0,0,0,0,3,0,0,0,0,0,3,0,0,0,0,0,0,3,0,3,3,3,0,3,0,0,0,3,3,3,3,3,3,0},
                {0,3,0,3,0,3,3,3,0,3,3,0,3,3,3,3,0,3,3,3,3,3,3,3,3,3,0,0,0,0,0,3,0,0,3,3,0,3,0,0,0,0},

                {0,3,0,3,0,3,0,3,0,3,0,0,0,3,0,3,0,3,0,3,0,0,0,0,0,3,0,3,0,0,0,3,0,3,3,0,0,3,0,0,0,3},
                {0,3,0,3,3,3,0,3,3,3,0,3,0,3,0,3,0,3,0,3,0,0,3,3,3,3,3,3,3,3,3,3,0,0,0,0,0,3,0,0,0,3},
                {0,3,0,0,0,0,0,3,0,0,0,3,0,3,0,3,0,0,0,3,0,0,3,0,0,0,0,3,0,0,0,0,0,3,3,3,3,3,3,0,3,3},
                {0,3,3,3,3,3,0,3,3,3,3,3,0,0,0,3,3,3,3,3,0,3,3,3,0,3,3,3,3,3,3,0,0,3,0,0,0,0,3,0,3,0},
                {0,0,0,0,0,3,0,0,0,3,0,0,0,3,0,0,3,0,3,0,0,0,0,0,0,0,0,0,0,0,3,0,0,3,0,3,3,3,3,0,3,0},
                {3,3,3,3,0,0,0,0,0,3,0,0,3,3,0,3,3,0,3,0,3,0,0,0,3,3,3,3,0,0,3,3,3,3,0,0,0,0,3,3,3,0},
                {3,0,0,0,0,0,0,3,3,3,0,0,3,0,0,3,0,0,0,0,3,0,3,3,3,0,0,0,0,0,0,0,0,0,0,3,3,0,3,0,0,0},
                {3,3,3,3,3,3,3,3,0,0,0,0,3,3,3,3,0,3,3,3,3,0,3,0,3,3,3,3,3,3,3,3,0,3,0,3,0,0,3,0,3,0},
                {0,0,0,3,0,0,0,3,0,0,3,0,0,0,0,0,0,3,0,3,0,0,0,0,0,0,0,3,0,0,0,0,0,3,0,3,3,3,3,3,3,0},
                {0,0,3,3,0,3,0,3,3,3,3,3,3,0,0,0,3,3,0,3,3,3,3,3,3,3,3,3,0,0,3,3,3,3,0,3,0,0,0,0,3,3},

                {3,0,0,3,0,3,0,0,3,0,0,0,3,0,0,0,3,0,0,0,0,0,0,3,0,0,0,0,0,0,3,0,0,0,0,3,0,0,0,0,0,3},
                {3,0,0,0,0,3,3,3,3,0,3,0,3,0,0,0,3,0,3,3,3,3,3,3,0,0,3,3,3,3,3,3,3,0,3,3,0,0,3,3,3,3},
                {3,3,3,3,0,0,0,0,0,0,3,0,3,3,3,0,0,0,3,0,0,0,3,0,0,3,3,0,0,3,0,0,0,0,3,0,0,0,3,0,0,0},
                {0,0,0,3,0,0,3,3,3,3,3,0,0,0,3,3,3,3,3,0,0,0,0,0,0,3,0,0,3,3,0,3,3,3,3,0,3,3,3,3,3,3},
                {0,3,0,3,3,3,3,0,0,0,3,3,3,0,0,3,0,0,3,3,3,0,0,3,0,0,0,3,3,0,0,3,0,0,0,0,0,0,0,0,0,3},
                {0,3,0,0,0,0,0,0,3,0,0,0,3,3,3,3,0,0,0,0,3,0,0,3,0,3,3,3,0,0,3,3,0,0,3,3,3,3,0,3,0,0},
                {3,3,3,3,0,3,3,3,3,3,0,0,0,0,0,0,0,3,0,0,3,0,0,3,0,3,0,3,0,3,3,0,0,0,0,3,0,0,0,3,0,3},
                {3,0,0,3,0,0,0,0,0,3,0,0,3,3,3,0,3,3,0,3,3,0,0,3,0,3,0,3,3,3,0,0,3,3,3,3,3,0,0,3,3,3},
                {3,0,0,3,0,3,3,3,0,3,3,3,3,0,0,0,3,0,0,3,0,0,0,3,3,3,0,0,3,0,0,0,3,0,0,0,3,0,0,3,0,0},
                {0,0,0,3,3,3,0,3,0,3,0,0,3,0,3,3,3,3,3,3,3,3,0,0,0,0,0,3,3,0,3,3,3,3,3,0,3,3,3,3,0,3},

                {0,3,0,3,0,0,0,0,0,3,0,0,3,3,3,0,0,0,0,0,0,3,0,3,0,0,3,3,0,0,3,0,0,3,0,0,0,3,0,0,0,3},
                {3,3,0,3,3,3,3,3,3,3,0,0,0,0,3,0,0,0,0,0,0,3,0,3,3,0,0,3,0,3,3,3,0,3,0,0,0,3,0,3,3,3},
                {3,0,0,0,3,0,0,0,0,0,0,3,3,0,3,3,3,3,3,0,0,3,0,0,3,0,3,3,0,3,0,3,0,3,3,3,3,3,0,3,0,0},
                {3,3,3,0,3,0,0,3,0,3,0,3,0,0,0,0,0,0,3,0,0,0,0,0,3,0,3,0,0,3,0,3,0,0,0,0,0,3,0,3,0,3},
                {0,0,3,0,3,0,3,3,0,3,0,3,3,3,0,3,3,0,3,3,3,3,3,0,3,0,3,3,3,3,0,3,0,3,0,3,0,0,0,3,0,3},
                {0,0,3,0,3,0,3,0,0,3,0,3,0,3,0,0,3,0,3,0,0,0,0,0,3,0,0,0,0,0,0,3,0,3,0,3,3,3,3,3,0,3},
                {0,3,3,0,3,0,3,3,3,3,0,3,0,3,3,3,3,0,3,3,3,0,0,3,3,3,0,3,3,0,0,3,0,3,0,0,0,0,3,0,0,3},
                {0,3,0,0,0,0,0,0,0,3,0,0,0,0,3,0,0,0,0,0,3,0,0,3,0,3,0,3,0,0,3,3,0,3,3,3,3,0,3,0,0,3},
                {0,3,3,3,3,0,0,0,0,3,3,3,3,3,3,0,3,3,3,3,3,3,0,3,0,3,3,3,3,3,3,0,0,0,3,0,3,0,3,3,3,3},
                {0,0,0,0,3,3,3,3,3,3,0,0,0,0,3,3,3,0,0,0,0,3,1,3,0,0,0,0,0,0,3,3,3,3,3,0,3,3,3,0,0,0}};

// small 20x20 maze
                int mat[][] = {{3,0,0,0,0,3,3,3,3,3,3,2,3,0,3,3,3,3,3,0},
                                {3,0,3,3,3,3,0,0,0,0,0,0,3,3,3,0,0,0,3,0},
                                {3,3,3,0,0,0,0,0,3,0,0,0,0,0,0,0,3,3,3,0},
                                {3,0,0,0,3,0,3,3,3,0,3,3,3,3,0,0,3,0,0,0},
                                {3,3,3,0,3,0,3,0,0,0,3,0,0,3,3,3,3,3,3,0},
                                {3,0,0,0,3,0,3,3,3,3,3,0,0,0,0,3,0,0,3,0},
                                {3,0,3,0,0,0,0,0,0,0,0,0,0,0,0,0,0,0,3,0},
                                {3,0,3,3,3,3,3,0,3,3,0,3,0,3,3,3,3,0,3,0},
                                {0,0,0,0,3,0,0,0,3,0,0,3,0,3,0,0,3,0,3,0},
                                {0,3,3,0,3,3,0,0,3,0,3,3,3,3,3,0,3,3,3,0},

                                {0,3,0,0,0,3,0,0,3,0,3,0,0,0,3,0,0,0,0,0},
                                {0,3,3,3,3,3,0,3,3,0,3,0,0,3,3,3,3,3,3,0},
                                {0,3,0,0,0,3,0,3,0,0,3,0,0,0,0,0,0,0,3,3},
                                {0,0,0,0,0,3,3,3,3,3,3,0,3,3,3,3,0,0,0,3},
                                {0,3,3,3,0,0,0,0,0,0,0,0,0,3,0,3,3,0,0,3},
                                {0,0,0,3,0,3,3,3,3,0,3,3,0,3,0,0,0,0,3,3},
                                {0,3,0,3,0,0,0,0,3,0,0,3,0,3,3,3,3,0,3,0},
                                {3,3,3,3,3,0,3,3,3,0,0,3,3,3,0,3,0,0,3,0},
                                {3,0,0,0,3,1,3,0,3,3,3,3,0,0,0,3,3,3,3,0}};
